韵母
————
zh	zh
ch	ch
sh	sh

ia	ia
ua	ua
uo	uo
vo	vo
ie	ie
ue	ue
er	er
ai/	ai
uai	uai
ei/	ei
uei	uei
ao	ao
iao	iao
ou/	ou
iou	iou
an	an
ian	ian
uan	uan
van	van
en	en
uen	uen
in	in
un	un
vn	vn
ang	ang
iang	iang
uang	uang
eng	eng
ing	ing
ueng	ueng
iong	iong
ong	ong


二音组合
————
ba	ba
bi	bi
bo	bo
bu	bu
ca	ca
ce	ce
ci	ci
cu	cu
da	da
de	de
di	di
du	du
fa	fa
fo	fo
fu	fu
ga	ga
ge	ge
gu	gu
ha	ha
he	he
hu	hu
ji	ji
ju	ju
ka	ka
ke	ke
ku	ku
la	la
le	le
li	li
lo	lo
lu	lu
lv	lv
ma	ma
me	me
mi	mi
mo	mo
mu	mu
na/	na
ne/	ne
ni/	ni
nu/	nu
nv/	nv
pa	pa
pi	pi
po	po
pu	pu
qi	qi
qu	qu
re/	re
ri	ri
ru	ru
sa	sa
se	se
si	si
su	su
ta	ta
te	te
ti	ti
tu	tu
wa	wa
wo	wo
wu	wu
xi	xi
xu	xu
ya	ya
ye	ye
yi	yi
yu	yu
za	za
ze	ze
zi	zi
zu	zu

iu	iu
ui/	ui
ng	ng


三音组合
————
bai	bai
ban	ban
bao	bao
bei/	bei
ben	ben
bie	bie
bin	bin
cai	cai
can	can
cao	cao
cen	cen
cha	cha
che	che
chu	chu
cou/	cou
cun	cun
cuo	cuo
dan	dan
dao	dao
dei/	dei
den	den
die	die
diu	diu
dou/	dou
dui/	dui
dun	dun
duo	duo
fan	fan
fei	fei
fen	fen
fou	fou
gai	gai
gan/	gan
gao	gao
gei	gei
gen/	gen
gon/	gon
gou	gou
gua	gua
gui	gui
gun	gun
guo/	guo
hai	hai
han	han
hao	hao
hei	hei
hen	hen
hou	hou
hua	hua
hui	hui
hun	hun
huo/	huo
jia	jia
jie	jie
jin	jin
jiu	jiu
jue	jue
jun	jun
kai	kai
kan	kan
kao	kao
kei	kei
ken	ken
kou	kou
kua	kua
kui	kui
kun	kun
kuo/	kuo
lai	lai
lan	lan
lao	lao
lei/	lei
lia/	lia
lie	lie
lin	lin
liu	liu
lou	lou
lve	lve
lun	lun
lvn	lvn
luo/	luo
mai	mai
man	man
mao	mao
mei/	mei
men	men
mie	mie
min	min
miu	miu
mou	mou
nao	nao
nei/	nei
nia/	nia
nie	nie
nin nin
niu	niu
nou	nou
nve	nve
nun nun
nuo/	nuo
pai	pai
pan	pan
pao	pao
pei/	pei
pen	pen
pie	pie
pin	pin
pou	pou
qia	qia
qie	qie
qin	qin
qiu	qiu
que	que
qun	qun
ran	ran
rao	rao
ren	ren
rou	rou
rui	rui
run	run
ruo/	ruo
sai	sai
san	san
sao	sao
sei	sei
sen	sen
sha	sha
she	she
shu	shu
sou	sou
sui	sui
sun	sun
suo/	suo
tai	tai
tan	tan
tao	tao
tei/	tei
tie	tie
tou	tou
tui	tui
tun	tun
tuo/	tuo
wai	wai
wan	wan
wei	wei
wen	wen
xia	xia
xie	xie
xin	xin
xiu	xiu
xue	xue
xun	xun
yan	yan
yao	yao
you	you
zai	zai
zan	zan
zao	zao
zei	zei
zen	zen
zha	zha
zhe	zhe
zhu	zhu
zou	zou
zui	zui
zun	zun
zuo/	zuo

整体认读音节
——————
zhi	zhi
chi	chi
shi	shi
yue	yue
yuan	yuan
yin	yin
yun	yun
ying	ying